10 10            
3101100101       
2010012010       
3000000003       
2100121010       
0010030111       
0000022100       
3003100003       
2010102010       
3100111010       
0100100110       
1 1              
8 8              
